########################
#                      #
#         B        K1   #
#                      #
#         BBB          #
#         R            #
#                      #
#                     L2 #
#    ###               #
#    #GD1               #
#    ###         L3      #
########################