########################
#                      #
#         B        K1   #
#                      #
#         BBB   L1       #
#         R            #
#                      #
#                      #
#    ###               #
#    #GD1               #
#    ###               #
########################