########################
#                      #
#                  K1   #
#                      #
#         E            #
#         R            #
#                      #
#                     L2 #
#    ###               #
#    #GD1               #
#    ###         L3      #
########################